90 160
1111111111111111111111111111111111111111111111111111111111111111111111111111111111111111111111111111111111111111111111111111111111111111111111111111111111111111
1111111111111111111111111111111111111111111111111111111111111111111111111111111111111111111111111111111111111111111111111111111111111111111111111111111111111111
1144444444444444444444444444444444444444444444444444444444444444444444444444444444411144444444444444444444444444444444444444444444444444444444444444444444444441
1140000000000000000000000000000000000000000000000000000000000000000000000000000000411140000000000000000000000000000000000000000000000000000000000000000000000041
1140000000000000000000000000000000000000000000000000000000000000000000000000000000411140000000000000000000000000000000000000000000000000000000000000000000000041
1140000000000000000000000000000000000000000000000000000000000000000000000000000000411140000000000000000000000000000000000000000000000000000000000000000000000041
1140000000000000000000000000000000000000000000000000000000000000000000000000000000411140000000000000000000000000000000000000000000000000000000000000000000000041
1140000000000000000000000000000000000000000000000000000000000000000000000000000000411140000000000000000000000000000000000000000000000000000000000000000000000041
1140000000000000000000000000000000000000000000000000000000000000000000000000000000056140000000000000000000000000000000000000000000000000000000000000000000000041
1140000000000000000000000000000000000000000000000000000000000000000000000000000000416140000000000000000000000000000000000000000000000000000000000000000000000041
1140000000000000000000000000000000000000000000000000000000000000000000000000000000416500000000000000000000000000000000000000000000000000000000000000000000000041
1140000000000000000000000000000000000000000000000000000000000000000000000000000000411140000000000000000000000000000000000000000000000000000000000000000000000041
1140000000000000000000000000000000000000000000000000000000000000000000000000000000411140000000000000000000000000000000000000000000000000000000000000000000000041
1144444444444444404444444444444444444444444444444444444444444444444444444444444444411140000000000000000000000000000000000000000000000000000000000000000000000041
1111111111111111161111111111111111111111111111111111111111111111111111111111111111111144444444444444444444444444444444444444444444440444444444444444444444444441
1111111111115555551111111111111111111111111111111111111111111111111111111111111111111111111111111111111111111111111111111111111111116111111111111111111111111111
1111111111116111111111111111111111111111111111111111111111111111111111111111111111111111111111111111155555555555555555555555555555555111111111111111111111111111
1144444444440444444444444444444444444444444444441114444444444444444444444444444444411111111111111111161111111111111111111111111111111111111111111111111111111111
1140000000000000000000000000000000000000000000041114000000000000000000000000000000411144444444444444404444444444441114444444444444444444444444444444444444444441
1140000000000000000000000000000000000000000000041114000000000000000000000000000000411140000000000000000000000000041114000000000000000000000000000000000000000041
1140000000000000000000000000000000000000000000041114000000000000000000000000000000411140000000000000000000000000041114000000000000000000000000000000000000000041
1140000000000000000000000000000000000000000000041114000000000000000000000000000000411140000000000000000000000000041114000000000000000000000000000000000000000041
1140000000000000000000000000000000000000000000005614000000000000000000000000000000411140000000000000000000000000041114000000000000000000000000000000000000000041
1140000000000000000000000000000000000000000000041650000000000000000000000000000000411140000000000000000000000000041650000000000000000000000000000000000000000041
1140000000000000000000000000000000000000000000041114000000000000000000000000000000411140000000000000000000000000005614000000000000000000000000000000000000000041
1140000000000000000000000000000000000000000000041114000000000000000000000000000000411140000000000000000000000000041114000000000000000000000000000000000000000041
1140000000000000000000000000000000000000000000041114000000000000000000000000000000411144444444444444444404444444441114000000000000000000000000000000000000000041
1140000000000000000000000000000000000000000000041114000000000000000000000000000000411111111111111111111161111111111114444444444444044444444444444444444444444441
1140000000000000000000000000000000000000000000041114000000000000000000000000000000411111111111111111111151111111111111111111111111611111111111111111111111111111
1140000000000000000000000000000000000000000000041114444444444444444444444404444444411111111111111111111161111111111111111111111111555555555555555555111111111111
1144444444444444044444444444444444444444444444441111111111111111111111111161111111111144444444444444444404444444441111111111111111111111111111111116111111111111
1111111111111111611111111111111111111111111111111111111155555555555555555551111111111140000000000000000000000000041114444444444444444444444444444440444444444441
1111111111111111555555555555555555555511111111111111111161111111111111111111111111111140000000000000000000000000041114000000000000000000000000000000000000000041
1111111111111111111111111111111111111611111111111114444404444444444444444444444444411140000000000000000000000000041114000000000000000000000000000000000000000041
1144444444444444444444444444444444444044444444441114000000000000000000000000000000411140000000000000000000000000041114000000000000000000000000000000000000000041
1140000000000000000000000000000000000000000000041114000000000000000000000000000000411140000000000000000000000000041114000000000000000000000000000000000000000041
1140000000000000000000000000000000000000000000041114000000000000000000000000000000411140000000000000000000000000041114000000000000000000000000000000000000000041
1140000000000000000000000000000000000000000000041114000000000000000000000000000000411140000000000000000000000000041114000000000000000000000000000000000000000041
1140000000000000000000000000000000000000000000041114000000000000000000000000000000411140000000000000000000000000041114000000000000000000000000000000000000000041
1140000000000000000000000000000000000000000000041114000000000000000000000000000000411140000000000000000000000000041114000000000000000000000000000000000000000041
1140000000000000000000000000000000000000000000041114000000000000000000000000000000411140000000000000000000000000041114000000000000000000000000000000000000000041
1144444444444444444444444444444440444444444444441114444444444444444444444444444444411144444444444444444444444444441114444444444444444444444444444444444444444441
1111111111111111111111111111111116111111111111111111111111111111111111111111111111111111111111111111111111111111111111111111111111111111111111111111111111111111
1111111111111111111111111155555555111111111111111111111111111111111111111111111111111111111111111111111111111111111111111111111111111111111111111111111111111111
1111111111111111111111111161111111111111111111111111111111111111111111111111111111111111111111111111111111111111111111111111111111111111111111111111111111111111
1144444444444444444444444404444444444444444441114444444444444444444444444444444444444111444444444444444444444444444444411144444444444444444444444444444444444441
1140000000000000000000000000000000000000000041114000000000000000000000000000000000004111400000000000000000000000000000411140000000000000000000000000000000000041
1140000000000000000000000000000000000000000041114000000000000000000000000000000000004111400000000000000000000000000000411140000000000000000000000000000000000041
1140000000000000000000000000000000000000000041114000000000000000000000000000000000004111400000000000000000000000000000416504444444444444444444444404444444444441
1140000000000000000000000000000000000000000005650000000000000000000000000000000000000565000000000000000000000000000000056111111111111111111111111161111111111111
1140000000000000000000000000000000000000000041114000000000000000000000000000000000004111400000000000000000000000000000411111111111111111111111111155111111111111
1140000000000000000000000000000000000000000041114000000000000000000000000000000000004111400000000000000000000000000000411111111111111111111111111116111111111111
1144444444444440444444444444444444444444444441114000000000000000000000000000000000004111400000000000000000000000000000411144444444444444444444444440444444444441
1111111111111116111111111111111111111111111111114000000000000000000000000000000000004111444444404444444444444444444444411140000000000000000000000000000000000041
1111111111111115555555555555551111111111111111114000000000000000000000000000000000004111111111161111111111111111111111111140000000000000000000000000000000000041
1111111111111111111111111111161111111111111111114000000000000000000000000000000000004111111111155555555555555511111111111140000000000000000000000000000000000041
1144444444444444444444444444404444444444444441114444444444440444444444444444444444444111111111111111111111111611111111111140000000000000000000000000000000000041
1140000000000000000000000000000000000000000041111111111111116111111111111111111111111111444444444444444444444044444444411140000000000000000000000000000000000041
1140000000000000000000000000000000000000000041111111111111555111111111111111111111111111400000000000000000000000000000411140000000000000000000000000000000000041
1140000000000000000000000000000000000000000041111111111111611111111111111111111111111111400000000000000000000000000000411140000000000000000000000000000000000041
1140000000000000000000000000000000000000000041114444444444044444444444444444444444444111400000000000000000000000000000411140000000000000000000000000000000000041
1140000000000000000000000000000000000000000041114000000000000000000000000000000000004111444444444444444444444444404444411144444444444444444444444444444444444441
1140000000000000000000000000000000000000000041114000000000000000000000000000000000004111111111111111111111111111161111111111111111111111111111111111111111111111
1140000000000000000000000000000000000000000041114000000000000000000000000000000000004111111111111111111111111111151111111111111111111111111111111111111111111111
1140000000000000000000000000000000000000000041114000000000000000000000000000000000004111111111111111111111111111161111111111111111111111111111111111111111111111
1140000000000000000000000000000000000000000041114000000000000000000000000000000000004111444444444444444444444444404411144444444444444444444444444444444444444441
1140000000000000000000000000000000000000000041114000000000000000000000000000000000004111400000000000000000000000000411140000000000000000000000000000000000000041
1144444444444444044444444444444444444444444441114444444444444444444444444444444444444111400000000000000000000000000411140000000000000000000000000000000000000041
1111111111111111611111111111111111111111111111111111111111111111111111111111111111111111400000000000000000000000000411140000000000000000000000000000000000000041
1111155555555555511111111111111111111111111111111111111111111111111111111111111111111111400000000000000000000000000056140000000000000000000000000000000000000041
1111161111111111111111111111111111111111111111111111111111111111111111111111111111111111400000000000000000000000000416500000000000000000000000000000000000000041
1144404444444444444444444444444444444444111444444444444444444444444444444444444444444111400000000000000000000000000411140000000000000000000000000000000000000041
1140000000000000000000000000000000000004111400000000000000000000000000000000000000004111400000000000000000000000000411140000000000000000000000000000000000000041
1140000000000000000000000000000000000004111400000000000000000000000000000000000000004111400000000000000000000000000411140000000000000000000000000000000000000041
1140000000000000000000000000000000000004165000000000000000000000000000000000000000004111400000000000000000000000000411140000000000000000000000000000000000000041
1140000000000000000000000000000000000004161400000000000000000000000000000000000000004111400000000000000000000000000411144444404444444444444444444444444444444441
1140000000000000000000000000000000000000561400000000000000000000000000000000000000004111400000000000000000000000000411111111161111111111111111111111111111111111
1140000000000000000000000000000000000004111400000000000000000000000000000000000000004111444404444444444444444444444411111111151111111111111111111111111111111111
1140000000000000000000000000000000000004111400000000000000000000000000000000000000004111111161111111111111111111111111111111161111111111111111111111111111111111
1144444444444444444444444444044444444444111444444444444444444444444044444444444444444111111155555555555111111111111111144444404444444444444444444444444444444441
1111111111111111111111111111611111111111111111111111111111111111111611111111111111111111111111111111116111111111111111140000000000000000000000000000000000000041
1111111111111155555555555555511111111111111111111111111111111111111555551111111111111111444444444444440444444444444411140000000000000000000000000000000000000041
1111111111111161111111111111111111111111111111111111111111111111111111161111111111111111400000000000000000000000000411140000000000000000000000000000000000000041
1144444444444404444444444444444444444444111444444444444444444444444444404444444444444111400000000000000000000000000411140000000000000000000000000000000000000041
1140000000000000000000000000000000000004111400000000000000000000000000000000000000004111400000000000000000000000000411140000000000000000000000000000000000000041
1140000000000000000000000000000000000004111400000000000000000000000000000000000000004111400000000000000000000000000411140000000000000000000000000000000000000041
1140000000000000000000000000000000000004111400000000000000000000000000000000000000004111400000000000000000000000000411140000000000000000000000000000000000000041
1140000000000000000000000000000000000004111400000000000000000000000000000000000000004111400000000000000000000000000411140000000000000000000000000000000000000041
1144444444444444444444444444444444444444111444444444444444444444444444444444444444444111444444444444444444444444444411144444444444444444444444444444444444444441
1111111111111111111111111111111111111111111111111111111111111111111111111111111111111111111111111111111111111111111111111111111111111111111111111111111111111111
