128 128
11111111111111111111111111111111111111111111111111111111111111111111111111111111111111111111111111111111111111111111111111111111
11111111111111111111111111111111111111111111111111111111111111111111111111111111111111111111111111111111111111111111111111111111
11000000000000000000000000011110000000000000000000000000000011110000000000000000000000000000000000000000111100000000000000000011
11000000000000000000000000011110000000000000000000000000000011110000000000000000000000000000000000000000111100000000000000000011
11000000000000000000000000011110000000000000000000000000000011110000000000000000000000000000000000000000111100000000000000000011
11000000000000000000000000044510000000000000000000000000000011110000000000000000000000000000000000000000111100000000000000000011
11000000000000000000000000011510000000000000000000000000000011110000000000000000000000000000000000000000445400000000000000000011
11000000000000000000000000011510000000000000000000000000000011540000000000000000000000000000000000000000111100000000000000000011
11000000000000000000000000011540000000000000000000000000000011510000000000000000000000000000000000000000111111151111111111111111
11000000000000000000000000011110000000000000000000000000000011510000000000000000000000000000000000000000111111151111111111111111
11000000000000000000000000011110000000000000000000000000000011511111111151111111111111111111111111111111111111144444111111111111
11000000000000000000000000011111111511111111111111111111111111511111111151111111111111111111111111111111111111111115111111111111
11000000000000000000000000011111111511111111111111111111111111511111111144444444444444444444444444441111111100000000000000000011
11000000000000000000000000011111111444111111111111111111111111511111111111111111111111111111111111151111111100000000000000000011
11000000000000000000000000011111111115444444444444444444444444510000000000000000000000000000000000000000111100000000000000000011
11000000000000000000000000011110000000000000001111000000000011110000000000000000000000000000000000000000111100000000000000000011
11111111111111151111111111111110000000000000001111000000000011110000000000000000000000000000000000000000111100000000000000000011
11111111111111151111111111111110000000000000001111000000000011110000000000000000000000000000000000000000111100000000000000000011
11111111111111144444111111111110000000000000001111000000000011110000000000000000000000000000000000000000111100000000000000000011
11111111111111111115111111111110000000000000001111000000000011110000000000000000000000000000000000000000111100000000000000000011
11000000000000000000000000011110000000000000001111000000000011110000000000000000000000000000000000000000111100000000000000000011
11000000000000000000000000011110000000000000004454000000000011110000000000000000000000000000000000000000111100000000000000000011
11000000000000000000000000011110000000000000001111000000000011111111111111111111111111111151111111111111111111111111111111111111
11000000000000000000000000011110000000000000001111000000000011111111111111111111111111111151111111111111111111111111111111111111
11000000000000000000000000011110000000000000001111000000000011111111111114444444444444444441111111111111111111111111111111111111
11000000000000000000000000011110000000000000001111000000000011111111111115111111111111111111111111111111111111111111111111111111
11000000000000000000000000011110000000000000001111000000000011110000000000000111100000000000001111000000000000000011110000000011
11000000000000000000000000011110000000000000001111000000000011110000000000000111100000000000001111000000000000000011110000000011
11000000000000000000000000011110000000000000001111000000000011110000000000000445100000000000001111000000000000000044510000000011
11000000000000000000000000011110000000000000001111000000000011110000000000000115100000000000004451000000000000000011510000000011
11000000000000000000000000011110000000000000001111000000000011110000000000000115100000000000001151000000000000000011510000000011
11000000000000000000000000011110000000000000001111000000000011110000000000000115400000000000001151000000000000000011510000000011
11111111115111111111111111111111111111111111111111111111111111110000000000000111100000000000001154000000000000000011510000000011
11111111115111111111111111111111111111111111111111111111111111110000000000000111100000000000001111000000000000000011510000000011
11111111114444444444411111111111111111111111111111111111111111110000000000000111100000000000001111000000000000000011510000000011
11111111111111111111511111111111111111111111111111111111111111110000000000000111100000000000001111000000000000000011510000000011
11000000000000000000000000001111000000000000000000000000000011110000000000000111100000000000001111000000000000000011510000000011
11000000000000000000000000001111000000000000000000000000000011110000000000000111100000000000001111000000000000000011510000000011
11000000000000000000000000004451000000000000000000000000000011110000000000000111100000000000001111111111115111111111510000000011
11000000000000000000000000001154000000000000000000000000000011110000000000000111100000000000001111111111115111111111510000000011
11000000000000000000000000001111000000000000000000000000000011110000000000000111100000000000001111111111114444444111510000000011
11000000000000000000000000001111000000000000000000000000000011110000000000000111100000000000001111111111111111115111510000000011
11000000000000000000000000001111000000000000000000000000000011110000000000000111100000000000001111000000000000000011510000000011
11000000000000000000000000001111000000000000000000000000000011110000000000000111100000000000001111000000000000000011510000000011
11000000000000000000000000001111000000000000000000000000000011111111111511111111111111111111111111000000000000000011540000000011
11000000000000000000000000001111000000000000000000000000000011111111111511111111111111111111111111000000000000000011110000000011
11000000000000000000000000001111000000000000000000000000000011111111444411111111111111111111111111000000000000000011110000000011
11000000000000000000000000001111000000000000000000000000000011111111511111111111111111111111111111000000000000000011110000000011
11000000000000000000000000001111000000000000000000000000000011110000000000000000000000000000001111115111111111111111111111111111
11000000000000000000000000001111000000000000000000000000000011110000000000000000000000000000001111115111111111111111111111111111
11111111111111111115111111111111000000000000000000000000000011110000000000000000000000000000001111114441111111111111111111111111
11111111111111111115111111111111111111111111115111111111111111110000000000000000000000000000001111111151111111111111111111111111
11111111111111111114444111111111111111111111115111111111111111110000000000000000000000000000001111000000000000000000000000000011
11111111111111111111115111111111111111111111114444444111111111110000000000000000000000000000001111000000000000000000000000000011
11000000000000000000000000001111111111111111111111115111111111110000000000000000000000000000001111000000000000000000000000000011
11000000000000000000000000001111000000000000000000000000000011110000000000000000000000000000001111000000000000000000000000000011
11000000000000000000000000001111000000000000000000000000000011110000000000000000000000000000001111000000000000000000000000000011
11000000000000000000000000001111000000000000000000000000000011110000000000000000000000000000001111000000000000000000000000000011
11000000000000000000000000001111000000000000000000000000000011110000000000000000000000000000001111000000000000000000000000000011
11000000000000000000000000001111000000000000000000000000000011110000000000000000000000000000001111000000000000000000000000000011
11000000000000000000000000001111000000000000000000000000000011110000000000000000000000000000001111000000000000000000000000000011
11000000000000000000000000001111000000000000000000000000000011110000000000000000000000000000001111000000000000000000000000000011
11000000000000000000000000001111000000000000000000000000000011110000000000000000000000000000001111000000000000000000000000000011
11111111111111111111151111111111111111111111111111111111111111111111111111111111111111111111111111111111111111111111111111111111
11111111111111111111151111111111111111111111111111111111111111111111111111111111111111111111111111111111111111111111111111111111
11111111111111111111141111111111111111111111111111111111111111111111111111111111111111111111111111111111111111111111111111111111
11111111111111111111151111111111111111111111111111111111111111111111111111111111111111111111111111111111111111111111111111111111
11000000000000000000000000001111000000001111000000001111000000000000000000000000000011110000000000000000000000000000000000000011
11000000000000000000000000001111000000001111000000001111000000000000000000000000000011110000000000000000000000000000000000000011
11000000000000000000000000001111000000001111000000001111000000000000000000000000000011110000000000000000000000000000000000000011
11000000000000000000000000001111000000001111000000001111000000000000000000000000000011110000000000000000000000000000000000000011
11000000000000000000000000001111000000001111000000001111000000000000000000000000000011110000000000000000000000000000000000000011
11000000000000000000000000001111000000001111000000001111000000000000000000000000000011540000000000000000000000000000000000000011
11000000000000000000000000001111000000001111000000001154000000000000000000000000000011510000000000000000000000000000000000000011
11000000000000000000000000001111000000001111000000004451000000000000000000000000000011510000000000000000000000000000000000000011
11000000000000000000000000004451000000001111000000001111000000000000000000000000000011510000000000000000000000000000000000000011
11000000000000000000000000001151000000001111000000001111000000000000000000000000000044510000000000000000000000000000000000000011
11111111111151111111111111111151000000001111000000001111000000000000000000000000000011110000000000000000000000000000000000000011
11111111111151111111111111111151000000001111000000001111000000000000000000000000000011111111111111111111111111511111111111111111
11111144444441111111111111111151000000004454000000001111000000000000000000000000000011111111111111111111111111511111111111111111
11111151111111111111111111111151000000001111000000001111000000000000000000000000000011111111111111144444444444411111111111111111
11000000000000000011110000001151000000001111000000001111111111111111111111111151111111111111111111151111111111111111111111111111
11000000000000000011110000001151000000001111000000001111111111111111111111111151111111110000000000000000000011110000000000000011
11000000000000000044510000001154000000001111000000001111111444444444444444444441111111110000000000000000000011110000000000000011
11000000000000000011510000001111000000001111000000001111111511111111111111111111111111110000000000000000000011110000000000000011
11111111111111151111510000001111000000001111000000001111000000001111000000000000000011110000000000000000000044540000000000000011
11111111111111151111510000001111000000001111000000001111000000001111000000000000000011110000000000000000000011110000000000000011
11111144444444441111510000001111111111511111111111111111000000001154000000000000000011111111111111111111115111110000000000000011
11111151111111111111510000001111111111511111111111111111000000001151000000000000000011111111111111111111115111110000000000000011
11000000000000000011510000001111111114411111111111111111000000001151000000000000000011111144444444444444444111110000000000000011
11000000000000000011510000001111111115111111111111111111000000001151000000000000000011111151111111111111111111110000000000000011
11000000000000000011510000001111000000000000000000001111000000001151000000000000000011110000000000000000000011110000000000000011
11000000000000000011540000001111000000000000000000001111000000001151000000000000000011110000000000000000000011110000000000000011
11000000000000000011110000001111000000000000000000001111000000001151111115111111111111110000000000000000000011110000000000000011
11000000000000000011110000001111000000000000000000001111000000001151111115111111111111110000000000000000000011110000000000000011
11000000000000000011110000001111000000000000000000001111000000004451114444111111111111110000000000000000000011110000000000000011
11000000000000000011110000001111000000000000000000001111000000001111115111111111111111110000000000000000000011110000000000000011
11000000000000000011110000001111000000000000000000001111000000001111000000000000000011110000000000000000000011110000000000000011
11000000000000000011110000001111000000000000000000001111000000001111000000000000000011110000000000000000000011110000000000000011
11000000000000000011110000001111000000000000000000001111000000001111000000000000000011110000000000000000000011110000000000000011
11000000000000000011110000001111000000000000000000001111000000001111000000000000000011110000000000000000000011110000000000000011
11000000000000000011110000001111000000000000000000001111000000001111000000000000000011110000000000000000000011110000000000000011
11111111111111115111111111111111111111111111111111111111111111111111111111111111151111111111111111111111111111111111111111111111
11111111111111115111111111111111111111111111111111111111111111111111111111111111151111111111111111111111111111111111111111111111
11114444444444444111111111111111111111111111111111111111111111111444444444444444441111111111111111111111111111111111111111111111
11115111111111111111111111111111111111111111111111111111111111111511111111111111111111111111111111111111111111111111111111111111
11000000000000000000000011110000000000000000000000001111000000000000000000000000000000000011110000000000000000000000000000000011
11000000000000000000000011110000000000000000000000001111000000000000000000000000000000000011110000000000000000000000000000000011
11000000000000000000000011110000000000000000000000001111000000000000000000000000000000000011110000000000000000000000000000000011
11000000000000000000000044510000000000000000000000001111000000000000000000000000000000000011110000000000000000000000000000000011
11000000000000000000000011510000000000000000000000001111000000000000000000000000000000000011110000000000000000000000000000000011
11115111111111111111111111510000000000000000000000001111000000000000000000000000000000000044510000000000000000000000000000000011
11115111111111111111111111540000000000000000000000001111000000000000000000000000000000000011540000000000000000000000000000000011
11114444444444411111111111110000000000000000000000001111000000000000000000000000000000000011110000000000000000000000000000000011
11111111111111511111111111110000000000000000000000001111000000000000000000000000000000000011110000000000000000000000000000000011
11000000000000000000000011110000000000000000000000001111111111111111111151111111111111111111110000000000000000000000000000000011
11000000000000000000000011110000000000000000000000001111111111111111111151111111111111111111111115111111111111111111111111111111
11000000000000000000000011111111111111111151111111111111111111111111111144441111111111111111111115111111111111111111111111111111
11000000000000000000000011111111111111111151111111111111111111111111111111151111111111111111111144111111111111111111111111111111
11000000000000000000000011111111111111111144444444411111000000000000000000000000000000000011111151111111111111111111111111111111
11000000000000000000000011111111111111111111111111511111000000000000000000000000000000000011110000000000000000000000000000000011
11000000000000000000000011110000000000000000000000001111000000000000000000000000000000000011110000000000000000000000000000000011
11000000000000000000000011110000000000000000000000001111000000000000000000000000000000000011110000000000000000000000000000000011
11000000000000000000000011110000000000000000000000001111000000000000000000000000000000000011110000000000000000000000000000000011
11000000000000000000000011110000000000000000000000001111000000000000000000000000000000000011110000000000000000000000000000000011
11000000000000000000000011110000000000000000000000001111000000000000000000000000000000000011110000000000000000000000000000000011
11111111111111111111111111111111111111111111111111111111111111111111111111111111111111111111111111111111111111111111111111111111
11111111111111111111111111111111111111111111111111111111111111111111111111111111111111111111111111111111111111111111111111111111
