128 128
11111111111111111111111111111111111111111111111111111111111111111111111111111111111111111111111111111111111111111111111111111111
11111111111111111111111111111111111111111111111111111111111111111111111111111111111111111111111111111111111111111111111111111111
11444444444444444444444444411144444444444411144444444444444444444111444444444444444111444444444444441114444444444411144444444441
11400000000000000000000000411140000000000411140000000000000000004111400000000000004111400000000000041114000000000411140000000041
11400000000000000000000000056140000000000056140000000000000000004111400000000000004111400000000000041650000000000411140000000041
11400000000000000000000000416140000000000416140000000000000000004111400000000000000561400000000000041614000000000411140000000041
11400000000000000000000000416140000000000416140000000000000000000561400000000000004161400000000000041614000000000411140000000041
11400000000000000000000000416500000000000416140000000000000000004161400000000000004161400000000000041614000000000411140000000041
11444444444044444444444444411140000000000416140000000000000000004161400000000000004161400000000000041614000000000416500000000041
11111111111611111111111111111140000000000416140000000000000000004161400000000000004161400000000000041614000000000416140000000041
11111111155511111111111111111140000000000416500000000000000000004161400000000000004161400000000000041614000000000416140000000041
11111111161111111111111111111140000000000411140000000000000000004161400000000000004161400000000000041614000000000416140000000041
11444444404444444444444444411140000000000411140000000000000000004161400000000000004161400000000000041614000000000416140000000041
11400000000000000000000000411140000000000411140000000000000000004161400000000000004161400000000000041614000000000416140000000041
11400000000000000000000000411140000000000411144444444444444444044165000000000000004161400000000000041614000000000416140000000041
11400000000000000000000000411140000000000411111111111111111111611111400000000000004161400000000000041614000000000056140000000041
11400000000000000000000000411140000000000411111555555555555555511111400000000000004161400000000000041614000000000411140000000041
11400000000000000000000000411140000000000411111611111111111111111111400000000000004161400000000000041614000000000411140000000041
11400000000000000000000000411140000000000411144044444444444444444111400000000000004161400000000000005614000000000411140000000041
11400000000000000000000000411140000000000411140000000000000000004111400000000000004161400000000000041114000000000411140000000041
11400000000000000000000000411140000000000411140000000000000000004111400000000000004161400000000000041114000000000411140000000041
11400000000000000000000000411140000000000411140000000000000000004111400000000000004161400000000000041114000000000411140000000041
11444444444404444444444444411144444444444411140000000000000000004111400000000000004161400000000000041114000000000411140000000041
11111111111161111111111111111111111111111111140000000000000000004111400000000000004161400000000000041114000000000411140000000041
11111111111155555551111111111111111111111111140000000000000000004111400000000000004161400000000000041114000000000411140000000041
11111111111111111161111111111111111111111111140000000000000000004111400000000000004165000000000000041114444044444411144444444441
11444444444444444404444111444444444444444411140000000000000000004111400000000000004111400000000000041111111611111111111111111111
11400000000000000000004111400000000000000411140000000000000000004111400000000000004111400000000000041111115511111111111111111111
11400000000000000000004111400000000000000411140000000000000000004111400000000000004111400000000000041111116111111111111111111111
11400000000000000000004165000000000000000411140000000000000000004111400000000000004111400000000000041114440444444411144444444441
11400000000000000000004161400000000000000411140000000000000000004111400000000000004111400000000000041114000000000411140000000041
11400000000000000000004161400000000000000411140000000000000000004111400000000000004111400000000000041114000000000411140000000041
11400000000000000000000561400000000000000411140000000000000000004111400000000000004111400000000000041114000000000411140000000041
11400000000000000000004111400000000000000411144444404444444444444111444444444444444111400000000000041114000000000411140000000041
11400000000000000000004111400000000000000411111111161111111111111111111111111111111111400000000000041114000000000411140000000041
11400000000000000000004111400000000000000411111115551111111111111111111111111111111111400000000000041114000000000411140000000041
11400000000000000000004111400000000000000411111116111111111111111111111111111111111111400000000000041114000000000411140000000041
11400000000000000000004111400000000000000411144440444444444411144444444444444444444111400000000000041114000000000056140000000041
11400000000000000000004111400000000000000411140000000000000411140000000000000000004111400000000000041114000000000416140000000041
11444444444444440444444111400000000000000411140000000000000411140000000000000000004111400000000000041114000000000416140000000041
11111111111111116111111111400000000000000411140000000000000411140000000000000000004111400000000000041114000000000416140000000041
11111555555555555111111111400000000000000411140000000000000416500000000000000000004111400000000000041114000000000416140000000041
11111611111111111111111111400000000000000411140000000000000416140000000000000000004111400000000000041114000000000416140000000041
11444044111444444444444111400000000000000411140000000000000416140000000000000000004111400000000000041114000000000416140000000041
11400004111400000000004111400000000000000411140000000000000416140000000000000000004111400000000000041114000000000416140000000041
11400004111400000000004111400000000000000411140000000000000416140000000000000000004111400000000000041114000000000416140000000041
11400004111400000000004111400000000000000411140000000000000416140000000000000000004111400000000000041114000000000416140000000041
11400004111400000000004111400000000000000411140000000000000416140000000000000000004111400000000000041114000000000416140000000041
11400004111400000000004111400000000000000411140000000000000416140000000000000000004111400000000000041114000000000416140000000041
11400004111400000000004111400000000000000411140000000000000416140000000000000000004111400000000000041114000000000416140000000041
11400004111400000000004111400000000000000411140000000000000416144444444444404444444111400000000000041114000000000416140000000041
11400004111400000000004111400000000000000411140000000000000416111111111111161111111111400000000000041114000000000416140000000041
11400004111400000000004111400000000000000411140000000000000416111111111111155511111111400000000000041114000000000416140000000041
11400000561400000000004111400000000000000411140000000000000416111111111111111611111111400000000000041114000000000416140000000041
11400004161400000000004111400000000000000411140000000000000416144444444444444044444111400000000000041114000000000416140000000041
11400004161400000000004111400000000000000411140000000000000416140000000000000000004111400000000000041114000000000416140000000041
11400004161400000000004111400000000000000411140000000000000416140000000000000000004111400000000000041114000000000416500000000041
11400004165000000000004111400000000000000411140000000000000416140000000000000000004111400000000000041114000000000411140000000041
11400004111400000000004111400000000000000411140000000000000416140000000000000000004111400000000000041114000000000411140000000041
11400004111400000000004111400000000000000411140000000000000416140000000000000000004111400000000000041114000000000411140000000041
11400004111400000000004111400000000000000411140000000000000416140000000000000000004111400000000000041114000000000411140000000041
11400004111400000000004111400000000000000411140000000000000056140000000000000000004111400000000000041114000000000411140000000041
11400004111400000000004111400000000000000411140000000000000411140000000000000000004111400000000000041114000000000411140000000041
11400004111400000000004111400000000000000411140000000000000411140000000000000000004111400000000000041114000000000411140000000041
11400004111400000000004111400000000000000411140000000000000411140000000000000000004111400000000000041114000000000411140000000041
11400004111400000000004111400000000000000411140000000000000411140000000000000000004111444444440444441114444444444411144444444441
11400004111400000000004111400000000000000411140000000000000411140000000000000000004111111111116111111111111111111111111111111111
11400004111400000000004111400000000000000411140000000000000411140000000000000000004111115555555111111111111111111111111111111111
11444444111444404444444111444444444444444411144444444444444411144444444444444444444111116111111111111111111111111111111111111111
11111111111111161111111111111111111111111111111111111111111111111111111111111111111111440441114444444444444441114444444444444441
11111111111111155111111111111111111111111111111111111111111111111111111111111111111111400041114000000000000041114000000000000041
11111111111111116111111111111111111111111111111111111111111111111111111111111111111111400041114000000000000041114000000000000041
11444444444444440444444444444444444444411144444444444444444444111444444444444444444111400041114000000000000041114000000000000041
11400000000000000000000000000000000000411140000000000000000004111400000000000000004111400041114000000000000041114000000000000041
11400000000000000000000000000000000000411140000000000000000004111400000000000000004111400041650000000000000041114000000000000041
11400000000000000000000000000000000000411140000000000000000004111400000000000000004111400041614000000000000041114000000000000041
11400000000000000000000000000000000000411140000000000000000004165000000000000000004111400041614000000000000041114000000000000041
11400000000000000000000000000000000000411140000000000000000004161400000000000000004111400041614000000000000041114000000000000041
11400000000000000000000000000000000000416500000000000000000004161400000000000000004111400041614000000000000041114000000000000041
11400000000000000000000000000000000000416140000000000000000004161444444404444444444111400041614000000000000041114000000000000041
11400000000000000000000000000000000000416140000000000000000000561111111161111111111111400041614000000000000041114000000000000041
11400000000000000000000000000000000000416140000000000000000004111111115551111111111111400041614000000000000041114000000000000041
11400000000000000000000000000000000000416144440444444444444444111111116111111111111111400041614000000000000005614000000000000041
11400000000000000000000000000000000000416111116111111111111111111444440444444444444111400041614000000000000041614000000000000041
11400000000000000000000000000000000000416111115555511111111111111400000000000000004111400041614000000000000041614000000000000041
11400000000000000000000000000000000000056111111111611111111111111400000000000000004111400005614000000000000041614000000000000041
11400000000000000000000000000000000000411144444444044444444444111400000000000000004111400041114000000000000041614000000000000041
11444444440444444444444444444444444444411140000000000000000004111400000000000000004111440441114444444444444441614000000000000041
11111111116111111111111111111111111111111140000000000000000004111400000000000000004111116111111111111111111111614000000000000041
11111555555111111111111111111111111111111140000000000000000004111400000000000000004111115555511111111111111111614000000000000041
11111611111111111111111111111111111111111140000000000000000004111400000000000000004111111111611111111111111111614000000000000041
11444044444444444441114444444411144444411140000000000000000004111400000000000000004111444444044441114444444441614000000000000041
11400000000000000041114000000411140000411140000000000000000004111400000000000000004111400000000041114000000041614000000000000041
11400000000000000041650000000411140000411144404444444444444444111444444444444444444111400000000041114000000041614000000000000041
11400000000000000041614000000411140000411111161111111111111111111111111111111111111111400000000041114000000041614000000000000041
11400000000000000041614000000411140000411111155555511111111111111111111111111111111111400000000041114000000041614000000000000041
11400000000000000041614000000411140000411111111111611111111111111111111111111111111111400000000041114000000041650000000000000041
11400000000000000041614000000411140000411144444444044444444411144444444444444444444111400000000041114000000041114000000000000041
11400000000000000041614000000411140000411140000000000000000411140000000000000000004111400000000041114000000041114000000000000041
11400000000000000041614000000056140000411140000000000000000411140000000000000000004111400000000041114000000041114000000000000041
11400000000000000041614000000416140000411140000000000000000056140000000000000000004111400000000041114000000041114000000000000041
11400000000000000041614000000416140000411140000000000000000416140000000000000000004111400000000041114000000041114000000000000041
11400000000000000005614000000416140000411140000000000000000416500000000000000000004111400000000041114000000041114000000000000041
11400000000000000041114000000416500000411140000000000000000411140000000000000000004111400000000041114000000041114000000000000041
11440444444444444441114000000411140000411140000000000000000411140000000000000000004111400000000041114000000041114000000000000041
11116111111111111111114000000411140000411144444444444440444411140000000000000000004111400000000041114000000041114000000000000041
11115111111111111111114000000411140000411111111111111116111111144444444404444444444111400000000041114000000041114000000000000041
11116111111111111111114000000411140000411111555555555555111111111111111161111111111111400000000041114000000041114000000000000041
11440111444444444441114000000411140000411111611111111111111111111155555551111111111111400000000041114000000041114000000000000041
11404111400000000041114000000411140000411144044111444444444411111161111111111111111111400000000041114000000041114000000000000041
11404111400000000041114000000411140000411140004111400000000411144404444444111444444111400000000041114000000041114000000000000041
11404111400000000041114000000411140000411140000561400000000411140000000004111400004111400000000041650000000041114000000000000041
11404111400000000041114000000411140000411140004161400000000411140000000004111400004111400000000041614000000041114000000000000041
11404111400000000041114440444411144444411140004161400000000411140000000000565000004111400000000041614000000041114000000000000041
11404111400000000041111116111111111111111140004161400000000411140000000004111400004111400000000041614000000041114000000000000041
11404111400000000041111115111111111111111140004161400000000411140000000004111400004111400000000041614000000041114000000000000041
11404111400000000041111116111111111111111140004161400000000411140000000004111400004111400000000041614000000041114000000000000041
11404111400000000041114440444444444444411140004165000000000411140000000004111400004111400000000041614000000041114000000000000041
11400561400000000041114000000000000000411140004111400000000411140000000004111400004111400000000041614000000041114000000000000041
11404161400000000041114000000000000000411140004111400000000411140000000004111400004111400000000041614000000041114000000000000041
11404161400000000041114000000000000000411140004111400000000411140000000004111400004111400000000041614000000041114000000000000041
11404161400000000041114000000000000000411140004111400000000411140000000004111400004111400000000041614000000041114000000000000041
11404165000000000041114000000000000000411140004111400000000411140000000004111400004111400000000041614000000041114000000000000041
11404111400000000041114000000000000000411140004111400000000411140000000004111400004111400000000005614000000041114000000000000041
11404111400000000041114000000000000000411140004111400000000411140000000004111400004111400000000041114000000041114000000000000041
11404111400000000041114000000000000000411140004111400000000411140000000004111400004111400000000041114000000041114000000000000041
11444111444444444441114444444444444444411144444111444444444411144444444444111444444111444444444441114444444441114444444444444441
11111111111111111111111111111111111111111111111111111111111111111111111111111111111111111111111111111111111111111111111111111111
