64 64
1111111111111111111111111111111111111111111111111111111111111111
1111111111111111111111111111111111111111111111111111111111111111
1144444444444444441114444444444444444444411144444444441114444441
1140000000000000041114000000000000000000411140000000041114000041
1140000000000000041650000000000000000000411140000000041114000041
1140000000000000005614000000000000000000416500000000041114000041
1140000000000000041114000000000000000000416140000000041114000041
1140000000000000041114000000000000000000416140000000041114000041
1140000000000000041114444444444044444444416140000000041114000041
1140000000000000041111111111111611111111116140000000041114000041
1140000000000000041111155555555511111111116140000000041114000041
1140000000000000041111161111111111111111116140000000041114000041
1140000000000000041114404111444444444444416140000000041114000041
1140000000000000041114004111400000000000416140000000041114000041
1140000000000000041114004111400000000000416140000000041114000041
1140000000000000041114004111400000000000416140000000041114000041
1140000000000000041114000561400000000000416140000000041114000041
1140000000000000041114004161400000000000416140000000041114000041
1140000000000000041114004161400000000000416140000000041114000041
1140000000000000041114004161400000000000416140000000041114000041
1140000000000000041114004161400000000000416140000000041114000041
1140000000000000041114004161400000000000416140000000041114000041
1140000000000000041114004161400000000000056140000000041114000041
1140000000000000041114004161400000000000411140000000041114000041
1140000000000000041114004161400000000000411140000000041114000041
1140000000000000041114004165000000000000411140000000041114000041
1140000000000000041114004111400000000000411140000000041114000041
1140000000000000041114004111400000000000411140000000005614000041
1140000000000000041114004111400000000000411140000000041614000041
1144444440444444441114444111444444444444411140000000041614000041
1111111116111111111111111111111111111111111140000000041650000041
1111111115555555551111111111111111111111111140000000041114000041
1111111111111111161111111111111111111111111140000000041114000041
1144444444444444404411144444444444444444411140000000041114000041
1140000000000000000411140000000000000000411140000000041114000041
1140000000000000000411140000000000000000411140000000041114000041
1140000000000000000056140000000000000000411140000000041114000041
1140000000000000000416140000000000000000411144044444441114444441
1140000000000000000416140000000000000000411111611111111111111111
1140000000000000000416140000000000000000411111511111111111111111
1140000000000000000416140000000000000000411111611111111111111111
1140000000000000000416500000000000000000411144041114444444444441
1140000000000000000411140000000000000000411140041114000000000041
1140000000000000000411144444444444444404411140041114000000000041
1144444444444404444411111111111111111161111140041114000000000041
1111111111111161111111111111115555555551111140005614000000000041
1111111555555551111111111111116111111111111140041614000000000041
1111111611111111111111144444440444444444411140041614000000000041
1144444044444444444411140000000000000000411140041614000000000041
1140000000000000000411140000000000000000411140041614000000000041
1140000000000000000411140000000000000000411140041614000000000041
1140000000000000000411140000000000000000411140041614000000000041
1140000000000000000411140000000000000000411140041614000000000041
1140000000000000000411140000000000000000411140041614000000000041
1140000000000000000411140000000000000000411140041614000000000041
1140000000000000000411140000000000000000411140041650000000000041
1140000000000000000411140000000000000000411140041114000000000041
1140000000000000000411140000000000000000411140041114000000000041
1140000000000000000411140000000000000000411140041114000000000041
1140000000000000000411140000000000000000411140041114000000000041
1140000000000000000411140000000000000000411140041114000000000041
1140000000000000000411140000000000000000411140041114000000000041
1144444444444444444411144444444444444444411144441114444444444441
1111111111111111111111111111111111111111111111111111111111111111
