90 160
1111111111111111111111111111111111111111111111111111111111111111111111111111111111111111111111111111111111111111111111111111111111111111111111111111111111111111
1111111111111111111111111111111111111111111111111111111111111111111111111111111111111111111111111111111111111111111111111111111111111111111111111111111111111111
1144444444444444444444444444444444444444444444444444444444444444444444444444444444444444444444444111444444444444444444444444444444411144444444444444444444444441
1140000000000000000000000000000000000000000000000000000000000000000000000000000000000000000000004111400000000000000000000000000000411140000000000000000000000041
1140020000000000000000000000000000000000000000000000000000000000000000000000000000000000000000004111400000000000000000000000000000411140000000000000000000000041
1140000000000000000000000000000000000000000000000000000000000000000000000000000000000000000000004111400000000000000000000000000000416500000000000000000000000041
1140000000000000000000000000000000000000000000000000000000000000000000000000000000000000000000004111400000000000000000000000000000416140000000000000000000000041
1140000000000000000000000000000000000000000000000000000000000000000000000000000000000000000000000561400000000000000000000000000000416144440444444444444444444441
1140000000000000000000000000000000000000000000000000000000000000000000000000000000000000000000004161400000000000000000000000000000056111116111111111111111111111
1140000000000000000000000000000000000000000000000000000000000000000000000000000000000000000000004165000000000000000000000000000000411111115111111111111111111111
1140000000000000000000000000000000000000000000000000000000000000000000000000000000000000000000004111400000000000000000000000000000411111116111111111111111111111
1140000000000000000000000000000000000000000000000000000000000000000000000000000000000000000000004111400000000000000000000000000000411144440444444111444444444441
1140000000000000000000000000000000000000000000000000000000000000000000000000000000000000000000004111444444444444444444444444440444411140000000004111400000000041
1140000000000000000000000000000000000000000000000000000000000000000000000000000000000000000000004111111111111111111111111111116111111140000000004111400000000041
1140000000000000000000000000000000000000000000000000000000000000000000000000000000000000000000004111111111111555555555555555555111111140000000004111400000000041
1140000000000000000000000000000000000000000000000000000000000000000000000000000000000000000000004111111111111611111111111111111111111140000000004111400000000041
1144444444444444444444444444444444444444444444444444444444444444444444444444444444444044444444444111444444444044444444444444444444411140000000004111400000000041
1111111111111111111111111111111111111111111111111111111111111111111111111111111111111611111111111111400000000000000000000000000000411140000000004165000000000041
1111111111111111115555555555555555555555555555555555555555555555555555555555555555555511111111111111400000000000000000000000000000411140000000004161400000000041
1111111111111111116111111111111111111111111111111111111111111111111111111111111111111111111111111111400000000000000000000000000000411140000000004161400000000041
1144444444444444440444444444444444444444444411144444444444444444444444444444444444444444444444444111400000000000000000000000000000411140000000004161400000000041
1140000000000000000000000000000000000000000411140000000000000000000000000000000000000000000000004111400000000000000000000000000000411140000000004161400000000041
1140000000000000000000000000000000000000000411140000000000000000000000000000000000000000000000004111400000000000000000000000000000411140000000000561400000000041
1140000000000000000000000000000000000000000056140000000000000000000000000000000000000000000000004111400000000000000000000000000000411140000000004111400000000041
1140000000000000000000000000000000000000000416500000000000000000000000000000000000000000000000004111400000000000000000000000000000411140000000004111400000000041
1144444444444440444444444444444444444444444411140000000000000000000000000000000000000000000000004111400000000000000000000000000000411140000000004111400000000041
1111111111111116111111111111111111111111111111140000000000000000000000000000000000000000000000004111400000000000000000000000000000411140000000004111400000000041
1111111111155555111111111111111111111111111111140000000000000000000000000000000000000000000000004111444444444444444444444444404444411144444444444111444444444441
1111111111161111111111111111111111111111111111140000000000000000000000000000000000000000000000004111111111111111111111111111161111111111111111111111111111111111
1144444444404444444444444444444444444444444411144444404444444444444444444444444444444444444444444111111111111111111111111111155555555555555511111111111111111111
1140000000000000000000000000000000000000000411111111161111111111111111111111111111111111111111111111111111111111111111111111111111111111111611111111111111111111
1140000000000000000000000000000000000000000411111111155555555555555555551111111111111111111111111111444444444444444444444444444444444444444044444444444444444441
1140000000000000000000000000000000000000000411111111111111111111111111161111111111111111111111111111400000000000000000000000000000000000000000000000000000000041
1140000000000000000000000000000000000000000411144444444444444444444444404444444444444444444444444111400000000000000000000000000000000000000000000000000000000041
1140000000000000000000000000000000000000000411140000000000000000000000000000000000000000000000004111400000000000000000000000000000000000000000000000000000000041
1140000000000000000000000000000000000000000411140000000000000000000000000000000000000000000000004111400000000000000000000000000000000000000000000000000000000041
1140000000000000000000000000000000000000000411140000000000000000000000000000000000000000000000004111400000000000000000000000000000000000000000000000000000000041
1140000000000000000000000000000000000000000411140000000000000000000000000000000000000000000000004111400000000000000000000000000000000000000000000000000000000041
1140000000000000000000000000000000000000000411140000000000000000000000000000000000000000000000004111400000000000000000000000000000000000000000000000000000000041
1140000000000000000000000000000000000000000411140000000000000000000000000000000000000000000000004111400000000000000000000000000000000000000000000000000000000041
1140000000000000000000000000000000000000000411140000000000000000000000000000000000000000000000004111400000000000000000000000000000000000000000000000000000000041
1140000000000000000000000000000000000000000411140000000000000000000000000000000000000000000000004111400000000000000000000000000000000000000000000000000000000041
1140000000000000000000000000000000000000000411140000000000000000000000000000000000000000000000004111400000000000000000000000000000000000000000000000000000000041
1144444444444444444404444444444444444444444411144444444444444444444444444444444444444444444444444111444444444444444444444444444444444444444444444444444444444441
1111111111111111111161111111111111111111111111111111111111111111111111111111111111111111111111111111111111111111111111111111111111111111111111111111111111111111
1111111111111111111155555555551111111111111111111111111111111111111111111111111111111111111111111111111111111111111111111111111111111111111111111111111111111111
1111111111111111111111111111161111111111111111111111111111111111111111111111111111111111111111111111111111111111111111111111111111111111111111111111111111111111
1144444444444444444444444444404444441114444444444444444444444444444444411144444444444444444444444444441114444444444444444444444444444444444444444444444444444441
1140000000000000000000000000000000041114000000000000000000000000000000411140000000000000000000000000041114000000000000000000000000000000000000000000000000000041
1140000000000000000000000000000000041114000000000000000000000000000000411140000000000000000000000000041114000000000000000000000000000000000000000000000000000041
1140000000000000000000000000000000041650000000000000000000000000000000411140000000000000000000000000005614000000000000000000000000000000000000000000000000000041
1140000000000000000000000000000000005614000000000000000000000000000000416500000000000000000000000000041614000000000000000000000000000000000000000000000000000041
1140000000000000000000000000000000041114000000000000000000000000000000056140000000000000000000000000041614000000000000000000000000000000000000000000000000000041
1140000000000000000000000000000000041114444444444444444444444440444444411144444444444444444444440444441614000000000000000000000000000000000000000000000000000041
1140000000000000000000000000000000041111111111111111111111111116111111111111111111111111111111116111111614000000000000000000000000000000000000000000000000000041
1140000000000000000000000000000000041111111111111111155555555555111111111111555555555555555555555111111614000000000000000000000000000000000000000000000000000041
1140000000000000000000000000000000041111111111111111161111111111111111111111611111111111111111111111111614000000000000000000000000000000000000000000000000000041
1140000000000000000000000000000000041114444444444444404444444444444444411144044444444444444444444444441614000000000000000000000000000000000000000000000000000041
1140000000000000000000000000000000041114000000000000000000000000000000411140000000000000000000000000041650000000000000000000000000000000000000000000000000000041
1144444444444444444444404444444444441114000000000000000000000000000000411140000000000000000000000000041114000000000000000000000000000000000000000000000000000041
1111111111111111111111161111111111111114000000000000000000000000000000411140000000000000000000000000041114444444444444444444444444444444444444444444444444440441
1111111111111111111155551111111111111114000000000000000000000000000000411140000000000000000000000000041111111111111111111111111111111111111111111111111111116111
1111111111111111111161111111111111111114000000000000000000000000000000411140000000000000000000000000041111115555555555555555555555555555555555555555555555555111
1144444444444444444404444444444444441114000000000000000000000000000000411140000000000000000000000000041111116111111111111111111111111111111111111111111111111111
1140000000000000000000000000000000041114000000000000000000000000000000411140000000000000000000000000041114440444444444444444444444444444444444444444444444444441
1140000000000000000000000000000000041114000000000000000000000000000000411140000000000000000000000000041114000000000000000000000000000000000000000000000000000041
1140000000000000000000000000000000041114000000000000000000000000000000411140000000000000000000000000041114000000000000000000000000000000000000000000000000000041
1140000000000000000000000000000000041114000000000000000000000000000000411140000000000000000000000000041114000000000000000000000000000000000000000000000000000041
1140000000000000000000000000000000041114000000000000000000000000000000411140000000000000000000000000041114000000000000000000000000000000000000000000000000000041
1140000000000000000000000000000000041114000000000000000000000000000000411140000000000000000000000000041114000000000000000000000000000000000000000000000000000041
1140000000000000000000000000000000041114000000000000000000000000000000411140000000000000000000000000041114000000000000000000000000000000000000000000000000000041
1144444444440444444444444444444444441114444444444444444444444444444444411140000000000000000000000000041114000000000000000000000000000000000000000000000000000041
1111111111116111111111111111111111111111111111111111111111111111111111111144444444444444444404444444441114444444444444444444444444444444444444444444444444444441
1111111111115111111111111111111111111111111111111111111111111111111111111111111111111111111161111111111111111111111111111111111111111111111111111111111111111111
1111111111116111111111111111111111111111111111111111111111111111111111111111111111111111111551111111111111111111111111111111111111111111111111111111111111111111
1144444444440444444444444444444444444444444444444444444444444444444444411111111111111111111611111111111111111111111111111111111111111111111111111111111111111111
1140000000000000000000000000000000000000000000000000000000000000000000411144444444444444444044444444444444444444444444444444444444444444444444444444444444444441
1140000000000000000000000000000000000000000000000000000000000000000000411140000000000000000000000000000000000000000000000000000000000000000000000000000000000041
1140000000000000000000000000000000000000000000000000000000000000000000411140000000000000000000000000000000000000000000000000000000000000000000000000000000000041
1140000000000000000000000000000000000000000000000000000000000000000000411140000000000000000000000000000000000000000000000000000000000000000000000000000000000041
1140000000000000000000000000000000000000000000000000000000000000000000411140000000000300000000000000000000000000000000000000000000000000000000000000000000000041
1140000000000000000000000000000000000000000000000000000000000000000000411140000000000000000000000000000000000000000000000000000000000000000000000000000000000041
1140000000000000000000000000000000000000000000000000000000000000000000411140000000000000000000000000000000000000000000000000000000000000000000000000000000000041
1140000000000000000000000000000000000000000000000000000000000000000000411140000000000000000000000000000000000000000000000000000000000000000000000000000000000041
1140000000000000000000000000000000000000000000000000000000000000000000411140000000000000000000000000000000000000000000000000000000000000000000000000000000000041
1140000000000000000000000000000000000000000000000000000000000000000000411140000000000000000000000000000000000000000000000000000000000000000000000000000000000041
1140000000000000000000000000000000000000000000000000000000000000000000411140000000000000000000000000000000000000000000000000000000000000000000000000000000000041
1140000000000000000000000000000000000000000000000000000000000000000000411140000000000000000000000000000000000000000000000000000000000000000000000000000000000041
1144444444444444444444444444444444444444444444444444444444444444444444411144444444444444444444444444444444444444444444444444444444444444444444444444444444444441
1111111111111111111111111111111111111111111111111111111111111111111111111111111111111111111111111111111111111111111111111111111111111111111111111111111111111111
